1000100010111011
1011101110011011
1000100010101011
1110101110110011
1000100010111011
1001010101001111
1010010101010111
1011010001001111