1000000000000000
1100000000000000
0011100000000000
0000000000000000
0000000000000000
0000000000000000
0000000011000000
0000000011200000